---------
-  ------
-       -
--     --
---     -
--   p  -
--    x -
--      -
---------