--------
-      -
-      -
-     --
- x    -
-   p  -
-      -
--------