--------
-      -
- x    -
-      -
-     --
--     -
-   p  -
-      -
--------