---------
---    --
--   p --
--  x   -
-       -
-      --
-  --  --
--     --
---------
---------