--------
-      -
-   x  -
-      -
-      -
-   p  -
-      -
--------